#15x15
(_a3_)(⇠a4_)(⇠a2_)......(_a0_)......(_b0_)......(_c0_)......(_d0_)
(_a2⇡)(_f1_)(_a2⇡)
(_a2⇡)(⇠a2_)(⇠a2⇡)......(_d0_)......(_e0_)......(_f0_)......(_a0_)

(_a0_)......(_b0_)......(_c0_)......(_d0_)......(_e0_)......(_f0_)

(_b0_)......(_c0_)......(_d0_)......(_e0_)......(_f0_)......(_a0_)

(_c0_)......(_d0_)......(_e0_)......(_f0_)......(_a0_)......(_b0_)

(_d0_)......(_e0_)......(_f0_)......(_a0_)......(_b0_)......(_c0_)