#15x15
............(_a0_)......(_b0_)......(_c0_)......(_d0_)......(_e0_)......(_f0_)
(_a1_)
(_a1⇡)......(_b0_)......(_c0_)......(_d0_)......(_e0_)......(_f0_)......(_a0_)
(_a1⇡)
(_a1⇡)......(_c0_)......(_d0_)......(_e0_)......(_f0_)......(_a0_)......(_b0_)
(_a1⇡)
(_d1⇡)......(_d0_)......(_e0_)......(_f0_)......(_a0_)......(_b0_)......(_c0_)
(_d1⇡)
(_d1⇡)......(_e0_)......(_f0_)......(_a0_)......(_b0_)......(_c0_)......(_d0_)
(_d1⇡)
(_d1⇡)......(_f0_)......(_a0_)......(_b0_)......(_c0_)......(_d0_)......(_e0_)