#15x15
[_a1_](_a0_)......(_b0_)......(_c0_)......(_d0_)......(_e0_)......(_f0_)

......(_b0_)......(_c0_)......(_d0_)......(_e0_)......(_f0_)......(_a0_)

......(_c0_)......(_d0_)......(_e0_)......(_f0_)......(_a0_)......(_b0_)

......(_d0_)......(_e0_)......(_f0_)......(_a0_)......(_b0_)......(_c0_)

......(_e0_)......(_f0_)......(_a0_)......(_b0_)......(_c0_)......(_d0_)

......(_f0_)......(_a0_)......(_b0_)......(_c0_)......(_d0_)......(_e0_)[_f1_]