(_e4_)......(_a0_)......(_b0_)......(_c0_)......(_d0_)......(_e0_)......(_f0_)
(_e1⇡)
(_e1⇡)......(_b0_)......(_c0_)......(_d0_)......(_e0_)......(_f0_)......(_a0_)
(_e1⇡)
(_e2⇡)......(_c0_)......(_d0_)......(_e0_)......(_f0_)......(_a0_)......(_b0_)
(_e3⇡)
(_e1⇡)......(_d0_)......(_e0_)......(_f0_)......(_a0_)......(_b0_)......(_c0_)
(_e1⇡)
(_e1⇡)......(_e0_)......(_f0_)......(_a0_)......(_b0_)......(_c0_)......(_d0_)
(_e1⇡)
............(_f0_)......(_a0_)......(_b0_)......(_c0_)......(_d0_)......(_e0_)