............(_a0_)......(_b0_)......(_c0_)......(_d0_)......(_e0_)......(_f0_)

(_R1_)......(_b0_)......(_c0_)......(_d0_)......(_e0_)......(_f0_)......(_a0_)
(_R1⇡)
(_R1⇡)......(_c0_)......(_d0_)......(_e0_)......(_f0_)......(_a0_)......(_b0_)
(_R1⇡)
(_R1⇡)......(_d0_)......(_e0_)......(_f0_)......(_a0_)......(_b0_)......(_c0_)
(_R1⇡)
............(_e0_)......(_f0_)......(_a0_)......(_b0_)......(_c0_)......(_d0_)

............(_f0_)......(_a0_)......(_b0_)......(_c0_)......(_d0_)......(_e0_)