#15x15
(_a3_)(⇠a2_)(⇠a2_)......(_a0_)......(_b0_)......(_c0_)......(_d0_)
(_a2⇡)......(_a2⇡)
(_a2⇡)......(_a2⇡)......(_e0_)......(_f0_)......(_a0_)......(_b0_)
(_a2⇡)......(_a2⇡)
(_a2⇡)(⇠a2_)(⇠a4⇡)......(_c0_)......(_d0_)......(_e0_)......(_f0_)

(_a0_)......(_b0_)......(_c0_)......(_d0_)......(_e0_)......(_f0_)

(_b0_)......(_c0_)......(_d0_)......(_e0_)......(_f0_)......(_a0_)
