#15x15
(_e2_)......(_a0_)......(_b0_)......(_c0_)......(_d0_)......(_e0_)......(_f0_)
(_R1⇡)
(_R1⇡)......(_b0_)......(_c0_)......(_d0_)......(_e0_)......(_f0_)......(_a0_)
(_R1⇡)
(_R1⇡)......(_c0_)......(_d0_)......(_e0_)......(_f0_)......(_a0_)......(_b0_)
(_R1⇡)
(_R1⇡)......(_d0_)......(_e0_)......(_f0_)......(_a0_)......(_b0_)......(_c0_)
(_R1⇡)
(_R1⇡)......(_e0_)......(_f0_)......(_a0_)......(_b0_)......(_c0_)......(_d0_)
(_R1⇡)
............(_f0_)......(_a0_)......(_b0_)......(_c0_)......(_d0_)......(_e0_)