#15x15
(_a0_)......(_b0_)......(_c0_)......(_a0_)......(_b0_)......(_c0_)

(_b0_)......(_c0_)......(_d0_)......(_d0_)......(_e0_)......(_f0_)

(_c0_)......(_d0_)......(_e0_)......(_a0_)......(_b0_)......(_c0_)

(_d0_)......(_e0_)......(_f0_)......(_d0_)......(_e0_)......(_f0_)

(_e0_)......(_f0_)......(_a0_)......(_b0_)......(_c0_)......(_d0_)

(_f0_)......(_a0_)......(_b0_)......(_c0_)......(_d0_)......(_e0_)