(_B2_)(⇠B2_)(_a0_)......(_b0_)......(_c0_)......(_d0_)......(_e0_)......(_f0_)
(_D1⇡)(⇠D1⇡)
(_F1⇡)(⇠F1⇡)(_b0_)......(_c0_)......(_d0_)......(_e0_)......(_f0_)......(_a0_)
(_A1⇡)(⇠A1⇡)
(_A1⇡)(⇠A1⇡)(_c0_)......(_d0_)......(_e0_)......(_f0_)......(_a0_)......(_b0_)
(_C1⇡)(⇠C1⇡)
(_E1⇡)(⇠E1⇡)(_d0_)......(_e0_)......(_f0_)......(_a0_)......(_b0_)......(_c0_)
(_D1⇡)(⇠D1⇡)
(_D1⇡)(⇠D1⇡)(_e0_)......(_f0_)......(_a0_)......(_b0_)......(_c0_)......(_d0_)
(_C1⇡)(⇠C1⇡)
............(_f0_)......(_a0_)......(_b0_)......(_c0_)......(_d0_)......(_e0_)